111111111
101111111
101101111
102101111
111111111