111111110
001111110
001101120
001101110
111111110